co_name|co_homepage|match_res
深圳市腾讯计算机系统有限公司|www.qq.com|@v
山石网科通信技术(北京)有限公司|www.hillstonenet.com.cn|@v
深圳市智莱科技股份有限公司|www.szzhilai.com|@v
杜肯(武汉)绝热材料有限公司|www.durkflex.cn|@v
金正大|www.kingenta.com|金正大 集团 官网
深圳市科仕朗光电科技有限公司|www.gtek.hk|深圳市 立翔慧 科光电科技有限公司
深圳市双赢伟业科技股份有限公司|www.allwins.com.cn|深圳市双赢伟业科技股份有限公司 官网
上海良信电器股份有限公司|www.sh-liangxin.com|上海良信电器股份有限公司 -良信电器
中控建设投资有限公司|shit homepage|match shit
美丽加芬(上海)化妆品有限公司|www.beautyplus.cn|@v
ITOO集团|www.|智能家居首选爱图 ITOO 一家专注于全宅智能家居控制系统的智能...
苏州天孚光通信股份有限公司|www.tfcsz.com|苏州天孚光通信股份有限公司
宁波江北搏戈户外用品有限公司|nb.caihao.com/comd-15031046333666.html|宁波江北搏戈户外用品有限公司 宁波江北搏戈户外用品有限公司招聘...
杭州凯美模具有限公司|iaoshan016273.11467.com|首页_ 杭州凯美模具有限公司
三生国健药业（上海）股份有限公司|www.cpgj-pharm.com|三生国健
宁波帅特龙集团有限公司|www.nbstl.cn|宁波帅特龙集团有限公司
米思米(中国)精密机械贸易有限公司|cn.misumi-ec.com|@v
江森自控(中国)投资有限公司|www.varta-automotive.cn|@v
苏州泛普科技股份有限公司|www.ucnano.com|@v
无锡德望科荣科技系统有限公司|shit homepage|match shit
上海秀玉贸易有限公司（Show-In Group）|shit homepage|match shit
北京环球之光科技发展有限公司|www.globalipl.com|北京环球之光科技发展有限公司
青岛华德仪表工程有限公司|www.qdhuade.com|青岛华德仪表工程有限公司
大连冶金轴承股份有限公司|www.dyzv-bearing.com|大连冶金轴承集团有限公司
上海骏易实业有限公司|junyishiye.cn.gtobal.com|上海骏易实业有限公司  网站
宁波爱发科真空技术有限公司|www.ulvac.com.cn|宁波爱发科真空技术有限公司
南京畅丰生物科技有限公司|shit homepage|match shit
浙江斯达克照明有限公司|www.starcolighting.com|斯达克
成都乐亦学网络科技有限公司|shit homepage|match shit
苏州恒久光电科技股份有限公司|www.sgt21.com|苏州恒久光电科技股份有限公司 _
徐州益电电力燃料有限公司|shit homepage|match shit
杭州初选信息技术有限公司|shit homepage|match shit
艾珐装帧材料(上海)有限公司|www.alpha3.com.cn|@v
广州海德国际货运代理有限公司宁波分公司|www.cargotrans.cn|广州海德国际货运代理有限公司
深圳市闻尚通讯科技有限公司|shit homepage|match shit
北京华科泰生物技术有限公司|www.huaketai.com|北京华科泰生物技术有限公司
UC优视（UC浏览器）|www.|UC浏览器 官网_ UC浏览器 电脑版_手机浏览器下载_手机/PC浏览器首选
浙江博世华环保科技有限公司|www.bestwa.com|博世华环保 -首页
江苏亚东朗升国际物流有限公司|www.loxson.com|江苏亚东朗升国际物流有限公司
北京同为基业科技发展有限公司|www.pdu.com.cn|@v
NOPPEN Group 诺本集团|www.lnoppen.com|noppen   group   诺本集团
上海移远通信技术股份有限公司|www.quectel.com/cn|上海移远通信技术股份有限公司
浙江九龙国际物流有限公司|www.jll.com.cn|九龙物流 ——首页
浙江明讯网络技术有限公司|mail.mingxun.cc|浙江明讯网络技术有限公司  - 邮箱用户登录
青岛今鹏翔投资有限公司|www.persun.com.cn|青岛今鹏翔投资有限公司
上海酷宇通讯技术有限公司|www.cooee.cn|"酷誉网络手机界面专业UI视觉设计 | COOEE Mobile Phone Interface..."
湖南意奇电子有限公司|18932923.pe168.com|【 湖南意奇电子有限公司 】 - 网站首页
广州海邦国际货运代理有限公司|www.united-ocean.com.cn|广州海邦货运代理有限公司
福建北峰通信科技股份有限公司|www.bfdx.com|福建北峰通信科技股份有限公司 -提供对讲机公网对讲机专业调频...
珠海云洲智能科技有限公司|www.yunzhou-tech.com|云洲智能 无人船-无人船行业领航者
上海环世物流（集团）有限公司|www.worldwide-logistics.cn|环世物流集团( Worldwide Logistics Group)
宁波奥克斯空调有限公司|www.|奥克斯 集团官网
凯希物流（天津）有限公司|kaixiliu.show.imosi.com|凯希物流(天津)有限公司
上海智裕创赢投资管理股份有限公司|www.smartwincapital.com|智裕创赢
厦门海集环宇国际物流有限公司深圳分公司|shit homepage|match shit
深圳和而泰智能控制股份有限公司|www.szhittech.com|@v
深圳市联点主题装饰设计工程有限公司|www.ua48.com|深圳联点 机构
深圳市汉智星科技有限公司|www.tostarcn.com|深圳市汉智星科技有限公司 官网
深圳市成为智能交通系统有限公司|www.chainwaytsp.cn|"...物流车队管理|企业车队管理|保险车联网- 深圳市成为智能 首页"
福州思博网络科技有限公司|www.spoto.net|@v
深圳市龙岗区龙岗华翔机械设备厂|www.szhx-tw.com|@v
广东碧桂园房地产信息咨询有限公司深圳分公司|www.bgy.com.cn|碧桂园
广州楠天网络科技有限公司|www.diannaoguanjia.top|@v
北京奇客创想信息技术有限公司|web.7k7k.com|@v
青岛浩宇运通国际物流有限公司|www.wide-trans.com|青岛浩宇运通国际物流有限公司
深圳市纵海控股有限公司|www.zoomhii.com|深圳市纵海控股有限公司
深圳龙翔通讯器材有限公司|www.lx1999.com.cn|龙翔通讯 官方网站
海利尔药业集团股份有限公司|www.hailir.cn|海利尔药业集团
武汉江通动画传媒股份有限公司|www.jtanimation.com|江通动画  首页
深圳市索纳光电有限公司|www.ledwise.cn/cn|深圳市索纳光电有限公司
广州科通展览有限公司|www.interwine.org|@v
丝路视觉科技股份有限公司|www.silucg.com|@v
云工工业科技(深圳)有限公司|www.yshouban.com|@v
深圳市瑞昕国际货运代理有限公司|www.sunrisegd.com|深圳市瑞昕国际货运代理有限公司
广东随时展科技有限公司|shit homepage|match shit
深圳市三联国际物流有限公司|www.ae-first.com|深圳市三联国际物流有限公司 -货运代理-深圳货代-集装箱运输-印巴...
周大生珠宝股份有限公司|www.chowtaiseng.com|周大生 官网(股票代码002867) - 中国 珠宝 连锁品牌 官网
无锡恒诺纺织科技有限公司|shit homepage|match shit
广州华汇信息科技有限公司|shit homepage|match shit
上海神马电力控股有限公司|www.shenmatech.com|江苏 神马电力 股份 有限公司
东方超捷国际货运代理（深圳）有限公司|www.olc-group.com|超捷 國際 物流 股份 有限公司  Oriental Logistics Group
广州市花安堂生物科技有限公司|www.huaantang.com|广州市花安堂生物科技有限公司
阳光电源股份有限公司|www.sungrowpower.com|@v
奇境互娱（深圳）科技有限公司|shit homepage|match shit
西安三基色电子科技有限公司|sq22907924.china.herostart.com|西安三基色电子科技有限公司
深圳倍声声学技术有限公司|www.bellsing.com|深圳倍声声学技术有限公司 官网
深圳市三木智能技术有限公司|www.mikimobile.cn|移动互联终端入口— 三木智能
深圳市一百度广告装饰有限公司|shit homepage|match shit
浩通国际货运代理有限公司|www.hital.com|浩通国际货运代理有限公司
广州速道信息科技有限公司|www.ysbang.cn|药师帮
深圳市汇威科技有限公司|www.szhomecare.cn|深圳市汇威科技有限公司
万利通金融服务（深圳）有限公司|www.aeasycredit.com|万利通金融服务(深圳)有限公司
无锡奥特维科技股份有限公司|www.wxautowell.com|@v
深圳市创世达实业有限公司|www.trusda.com|深圳市创世达实业有限公司
无锡觅睿恪科技有限公司|www.mirarobot.com|无锡觅睿恪科技有限公司
深圳安信卓科技有限公司|www.anxinzhuo.com|...、集群系统等专业无线通信设备网站首页 深圳安信卓科技有限公司
先歌国际影音有限公司|www.iaggroup.cn|先歌国际影音有限公司
深圳市灵畅互动科技有限公司|www.fitouch.com.cn|灵畅互动科技 _电子白板_纳米黑板_会议平板 官网
畅娱互动科技（北京）有限公司|www.adzshd.com|掌上 互动 ——全球领先的移动全案营销平台
上海福汇医疗器械有限公司|23a495888.atobo.com.cn|上海福汇医疗器械有限公司  - 主页
深圳市卡酷奇科技有限公司|companyadc.51job.com/companyads/2016/shzh/kaku0222_7421wh/index.htm|【 深圳市卡酷奇科技有限公司 招聘求职】深圳市卡酷奇科..._前程无忧
上海益民食品一厂（集团）有限公司销售分公司|www.ymspjt.com|益民食品集团
上海顶尖国际物流有限公司|1577539.show160.com|首页 上海顶尖国际物流有限公司
深圳泡椒思志信息技术有限公司|www.paojiao.com|@v
长兴马可威国际货运代理有限公司|www.marcowinlogistics.com|长兴马可威国际货运代理有限公司 Changxing Marco Win ...
伟乐视讯科技股份有限公司|www.wellav.com|伟乐科技  -  伟乐科技 官网
深圳云麦科技有限公司|www.iyunmai.com|云麦科技 官网 - 好轻、好轻2、好轻Se、好轻Color、好轻mini、好轻...
深圳市振邦智能科技有限公司|www.ezhenbang.com|深圳市振邦智能科技有限公司
广东正业科技股份有限公司|www.zhengyee.com|@v
苏州英威腾电力电子有限公司|www.invt-electrics.com|苏州英威腾电力电子有限公司
艺巢公司（ATCHAIN）|www.|atchain艺巢公司 网站前端及程序开发
深圳市金辉拓科技有限公司|www.jht-group.com|深圳市金辉拓科技有限公司
维度智华管理顾问(北京)有限公司|www.wedochina.com.cn|@v
宁波森木进出口有限公司|sunmoon.yanmo.net|宁波森木进出口有限公司
硕诺科技(深圳)有限公司|www.lavainternational.cn|@v
融商物流（上海）有限公司|shit homepage|match shit
钻石世家国际珠宝有限公司|www.shininghouse.cn|钻石世家
深圳斯达莱特亮化科技有限公司|sidalit.1688.com|深圳斯达莱特亮化科技有限公司
深圳市深远企业顾问有限公司|www.shenyuan.net|深圳市深远企业顾问有限公司
深圳市果酱时代科技有限公司|www.guojiang.tv|果酱 直播-中国华裔美少年偶像の社区
光漾联萌互联网金融信息服务（上海）有限公司|www.sunallies.com|上市 公司 旗下、专注供应链 金融 的绿色理财平台_光合 联萌 官网
华一联合集团股份有限公司|www.fsua.cn|华一联合集团
长沙远程出国留学服务有限公司|www.ycworld.net|"...专业 服务 | 长沙出国留学 网|海外留学- 远程出国留学服务有限公司"
深圳优美创新科技有限公司|www.umeox.com|@v
广州市爱牌信息科技有限公司|27168541.b2b.11467.com|首页_ 广州市爱牌信息科技有限公司
北京丰珅易博国际建筑装饰工程有限公司|shit homepage|match shit
北京易普斯咨询有限责任公司|www.eap.com.cn|@v
江西晶科光伏材料有限公司|www.jinkopvm.com|江西晶科光伏材料有限公司
上海海隆软件有限公司|www.hyron.com|上海海隆软件有限公司
深圳市立洋光电子股份有限公司|www.lepowerled.cn|@v
杭州安杰思生物科技有限公司|www.bioanyu.com|杭州安杰思生物科技有限公司
海宁好德软件科技有限公司杭州分公司|1835066.atobo.com.cn|海宁好德软件科技有限公司杭州分公司  - 主页
纽威集团|www.|纽威 数控装备(苏州)有限公司
网宿科技股份有限公司|www.wangsu.com|@v
纽威数控装备（苏州）有限公司|www.newaycnc.com|纽威数控装备(苏州)有限公司
深圳市泰洲物流有限公司|claudia123.cn.globalimporter.net|深圳市泰洲物流有限公司
深圳瞬移达国际物流有限公司|utec164907250.cn.globalimporter.net|深圳瞬移达国际物流有限公司
广州卓梦科技有限公司|www.dituiba.com|@v
北京恒骏智业管理咨询有限责任公司|23a12503.atobo.com.cn|北京恒骏智业管理咨询有限责任公司  - 主页
深圳市酷骑电子科技有限公司|shit homepage|match shit
深圳市伟跃科技有限公司|shit homepage|match shit
惠州市创荣发实业有限公司|www.cn-cdrc.com|惠州市创荣发实业有限公司
江苏盐电阀门有限公司苏州分公司|www.ydfvalve.com|盐电阀门  YDF VALVE
柏斯琴行（中国）有限公司|www.parsonsmusic.com.cn|柏斯琴行 -中港连锁100家 世界7大乐器零售商 钢琴、电钢、电子琴、...
青岛特锐德电气股份有限公司|www.qdtgood.com|青岛特锐德电气股份有限公司 官网
凌云新创信息科技（深圳）有限公司|shit homepage|match shit
上海华民国际旅行社有限公司|www.huamin.com.hk|上海华民国际旅行社有限公司
深圳市多科电子有限公司|shit homepage|match shit
深圳市海纳时代电子有限公司|www.szhi-net.com.cn|...-- 深圳市海纳时代电子有限公司 _POE交换机POE Switch POE中跨...
深圳市博阅科技股份有限公司|www.boyue.com|博阅科技
深圳市熙盛科技有限公司|27542515.b2b.11467.com|首页_ 深圳市熙盛科技有限公司
北京若森数字科技有限公司|www.rocen.com.cn|北京若森数字科技有限公司
UK AOPH GROUP LTD|shit homepage|match shit
上海商霖华通投资咨询有限公司|www.businessconnectchina.com|@v
青岛俊鑫国际物流有限公司|qdxinjun.member.4plog.com|青岛俊鑫国际物流有限公司
安得生医疗投资管理（北京）有限公司|www.aihmbj.com|"...肿瘤术后康复|康复产品- 安得生医疗投资管理(北京)有限公司"
深圳市志腾永盛科技有限公司|chitechpc.cn.china.cn|深圳志腾永盛科技有限公司  – 首页
上海联适导航技术有限公司|www.allynav.cn|上海联适导航技术有限公司
深圳市微特自动化设备有限公司|www.microtesttech.com|深圳市微特自动化设备有限公司
深圳市德朗能电子科技有限公司|www.dlgbattery.cn|@v
深圳仝安技术有限公司|www.tongansz.com|深圳仝安技术有限公司
珠海市利保机器人有限公司|www.thybot.com|Thybot Robotics——拥有中国顶尖技术的 机器人 智能商店设计、研发...
宁波智联国际物流有限公司|shit homepage|match shit
华春建设工程项目管理有限责任公司|www.huachun.asi|华春建设工程项目管理有限责任公司  甲级 工程造价 造价咨询 招标...
广州万居隆电器有限公司|www.dotels.cn|广州万居隆电器有限公司 官网
深圳市维度科技有限公司|www.weidujs.com|@v
深圳市科利尔照明有限责任公司|www.clearlighting.com|深圳市科利尔照明有限责任公司
武汉天汽模志信汽车模具有限公司|whtqmzxqcmjyxgs.21hubei.com|武汉天汽模志信汽车模具有限公司
上海宽创国际文化创意有限公司|www.broadmesse.com|@v
广东德诚行地产集团有限公司|www.dchcn.com|德诚行 -首页
数据堂 (北京)科技股份有限公司|www.datatang.com|@v
贝朗（中国）卫浴有限公司|www.bravat.com.cn|.: 德国 贝朗卫浴  :.
杭州拓天科技有限公司|3833451.71ab.com|杭州拓天科技有限公司 _首页
萌恒集团国际贸易事业部|shit homepage|match shit
广州领思动漫科技有限公司|shit homepage|match shit
江西江铃海外汽车销售服务有限公司|shit homepage|match shit
深圳市赛盈地脉技术有限公司|shit homepage|match shit
金华市博宇企业管理咨询有限公司|23a2528921.atobo.com.cn|金华市博宇企业管理咨询有限公司  - 主页
广州佰深国际货运代理有限公司|binesion.cn.makepolo.com|广州佰深国际货运代理有限公司 广州佰深国际货运代理有限公司网站...
湖南海翼电子商务股份有限公司深圳分公司|www.oceanwing.com.cn|湖南海翼电子商务股份有限公司
深圳市泰永科技股份有限公司|www.taiyong.net|贵州 泰永 长征技术 股份有限公司  - 智驭动静之变 能享绿色未来
上海巴安水务股份有限公司|www.safbon.com|上海巴安水务股份有限公司 官网
深圳市斯腾乐科技有限公司|shit homepage|match shit
中策橡胶集团有限公司|www.chaoyang.com|@v
上海锦茗国际货物运输代理有限公司|fangshun58.1688.com|上海锦茗国际货物运输代理有限公司
焦作科瑞森重装股份有限公司|www.jzcreation.com|焦作科瑞森重装股份有限公司
广州市天使之驿国际货运代理有限公司|www.angelwingcargo.com|广州市天使之驿国际货运代理有限公司 ——国际航空货运国际快递...
深圳市比翼小蜜蜂科技有限公司|www.beexmf.com|深圳市比翼小蜜蜂科技有限公司
华迅时代商务顾问（北京）有限公司|16037571.1024sj.com|华迅时代商务顾问(北京)有限公司 -首页
恒信科技集团股份有限公司|www.cnhanxing.com|全球知名电子烟和电子烟油生产厂家_ 恒信科技集团 官网
深圳市莱蒙特科技有限公司|reymonttech.en.alibaba.com|深圳市莱蒙特科技有限公司
深圳市捷高国际货运代理有限公司|ibdjetpropsz.ce.c-c.com|深圳市捷高国际货运代理有限公司
中国检验认证集团深圳有限公司|www.ccicshenzhen.com.cn|中国检验认证集团深圳有限公司 CCIC-深圳最具权威第三方检验认证...
